................
...&&&&&&&&&&&&&
................
&&&...&&........
...&&&..&&&&....
...............c
...&&&&&&&&&&&&&
h...ww.............
&&&&&&&.www.&......
.......&&--&&...
..............
&&&&&&-&--&&&&&