................
...&&&&&&&&&&&&&
ej..............
&&&...&&..j.....
...&&&..&&&&.j..
........j......c
...&&&&&&&&&&&&&
h.......j.......
&&&&&&&..&......
.......&&--&&...
..wjw...........
&&&&&&-&--&&&&&&