................
...&&&&&&&&&&&&&
................
&&&...&&........
...&&&..&&&&....
................
...&&&&&&&&&&&&&
................
&&&&&&&.........
.......&&--&&...
................
h&&&&&&-&--&&&&&