................
&&.............
................
.........&&.....
................
................
.....&&.................
................
...&&...........
................
.........&......
.....&&&........
................
..&&............
.h&.............
&&&&&--------&&