................
...&&&&&&&&&&&&&
................
&&&...&&........
...&&&..&&&&....
...............c
...&&&&&&&&&&&&&
h................
&&&&&&&..&......
.......&&--&&...
..www............
&&&&&&-&--&&&&&