................
&&.............
................
.........&&.....
...&&...........
..........&&&&..
........&&......
.....&&&........&&&
................
..&&............
.h&.............
&&&&&--------&&