................
................
................
................
................
................
.........&......
.....&&&........
................
..&&............
h...............
&&&&&&--------&&