................
................
................
................
................
................
.........&......
.....&&&........
................
..&&............
.&.............
h&&&&&--------&&