........................
........................
........................
........................
........................
........................
........................
........................
.......................c
....j.......&&....&&..&&
.h.....w...j....&&&&....
-&&&--&&--&&--&&&&&&&&&&