................
..............&&
................
..&&---&-&&&&&&&
.&..............
...........&&...
&&&&&&&&&&&....c
.............&&&
.............&..
..........&&..
.h..ww.......&.....
&&&&&&&&&&&--&&