................
..............&&
................
..&&---&-&&&&&&&
.&..............
...........&&...
&&&&&&&&&&&.....
..............&&
................
............&&..
................
h&&&&&&&&&&&--&&