................
..............&&
................
..&&---&-&&&&&&&
.&..............
...........&&...
&&&&&&&&&&&....c
..............&&
.............&..
...........&..
.h..ww.......&.....
&&&&&&&&&&&--&&