................
.........j....&&
................
..&&---&-&&&&&&&
.&..j...........
...........&&...
&&&&&&&&&&&....c
.............&&&
......j......&..
.....j....&&..
.h..ww.......&..
&&&&&&&&&&&--&&&