................
&&..............
..&--&..j.......
.......e..&&....
.......&&&......
..&--&........c.
........j....&&.
&&..............
.....j..&&&-&...&
....j...&....&..
...www.&.....&..
h&&&&&&&&&&&&&&&