................
&&..............
..&--&..........
..........&&....
.......&&&......
..&--&.......&&.
................
&&..............
.........&-&...&
........&...&...
.......&.....&..
h&&&&&&&&&&&&&&&