................
&&..............
..&--&..........
..........&&....
.......&&&......
..&--&........c.
.............&&.
&&..............
.........&&&-&...&
........&....&..
...www.&.....&..
h&&&&&&&&&&&&&&&
