................
................
.....j..........
....&&&&&-&&&&&&
................
.&&....j...j....
................
..j.&&&&&&&&&&..
...............c
..&&&&&&&&&&&&&&
................
h&&&&-&&-&&&-&&&