................
................
................
....&&&&&-&&&&&&
................
.&&.............
................
....&&&&&&&&&&&&
...............c
..&&&&&&&&&&&&&&
................
h&&&&-&&-&&&-&&&