................
....&&...&&&....
&&-&..&&&.......
...........&&&..
.......&-&&.....
..&&-&&......&&&
...........&&...
.........&&...&&
.......&&.......
.........&&&&...
...&&&&.........
h&-&&&&&&&&&&&&&