................
....&&...&&&....
&&-&..&&&.......
...........&&&..
.......&-&&....c
..&&-&&......&&&
...........&&...
.........&&...&&
.......&&.......
.........&&&&...
h..&&&&.........
&&&&&&&&&&&&&&&&