................
....&&.j.&&&....
&&-&..&&&.......
...j.......&&&..
.......&-&&..j.c
..&&-&&......&&&
.......j...&&...
.........&&...&&
....j..&&.......
.........&&&&...
h..&&&&.........
&&&&&&&&&&&&&&&&