................
...........c....
........jw.&....
................
.......w&&&-....
......w.........
.....j.&-.......
................
..j.&-&..........
...w............
h..&............
&&&&&&&&&&&&&&&&

