................
................
................
................
................
................
.......j...w.w..
.......&..&&&&..
..ww.........c..
..&&.j..&&&.&&..
h....&.....&&&..
&&&-&&&-&&&&&&&&
