................
................
................
................
................
................
.......j........
.......&........
..ww.........c..
..&&.j..&&&.&&..
h....&.....&&&..
&&&-&&&-&&&&&&&&
