................
................
................
................
................
...............c
.....w.........&
..j.&&........&&
.......j.....&&&
..&&..&&&...&&&&
h..........&&&&&
&&&&&&&-&&&&&&&&