........................
........................
.........................
.........................
.........................
......................www
......................www
.........................
&&&-&&......&&&&&&....&&&
.......www........jjj....
h......www.&......jjj&&&c
&&&&&&&&&&&&&&&&&&&&&&&&&